17 6 9 9 9 6 9 9 9 6 9 9 9 6 9 9 9 6 9 9
14 7 9 9 9 7 9 9 9 7 9 9 9 7 9 9 9 7 9 9
11 8 9 9 9 8 9 9 9 8 9 9 9 8 9 9 9 8 9 9
9 9 9 9 9 9 9 9 9 9 9 9 9 9 9 9 9 9 9 9
9 9 9 9 9 9 9 9 9 9 9 9 9 9 9 9 9 9 9 9
17 17 17 17 17 17 17 17 17 17 17 17 17 17 17 17 18 18 17 17
17 17 17 17 17 17 17 17 17 17 17 17 17 17 17 17 18 18 17 17
17 17 17 17 17 17 17 17 17 17 17 17 17 17 17 17 18 18 17 17
17 17 17 17 17 17 17 17 17 17 17 17 17 17 17 17 18 18 17 17
17 6 17 17 17 17 17 17 17 17 17 17 17 17 17 17 18 18 17 17
14 7 14 14 14 14 14 14 14 14 14 14 14 14 14 14 18 18 14 14
11 8 11 11 11 11 11 11 11 11 11 11 11 11 11 11 18 18 11 11
9 9 9 9 9 9 9 9 9 9 9 9 9 9 9 9 9 9 9 9
9 9 9 9 9 9 9 9 9 9 9 9 9 9 9 9 9 9 9 9
9 9 9 9 9 9 9 9 9 9 9 9 9 9 9 9 9 9 9 9
9 9 9 9 9 9 9 9 9 9 9 9 9 9 9 9 9 9 9 9
9 9 9 9 9 9 9 9 16 16 16 16 9 9 9 9 9 9 9 9
9 9 9 9 9 9 9 9 16 16 16 16 9 9 9 9 9 9 9 9
9 9 9 9 9 9 9 9 16 16 16 16 9 9 9 9 9 9 9 9
17 17 17 17 17 17 17 17 17 16 16 17 17 17 17 17 17 17 17 17