14 14 14 14 14 14 14 14 14 14 14 14 14 14 14 14 14 14 14 14
11 11 12 11 11 12 11 11 11 12 11 11 11 12 11 15 13 11 11 11
9 9 9 9 9 9 9 9 9 9 9 9 9 9 9 9 9 9 9 9
9 9 9 9 9 9 9 9 9 9 9 9 9 9 9 9 9 9 9 9
9 9 9 9 9 9 9 9 9 9 9 9 9 10 9 9 9 9 9 9
9 9 9 9 9 9 10 9 9 9 9 9 9 9 9 9 9 9 9 9
9 9 9 9 9 9 9 9 16 16 16 16 9 9 9 9 9 9 9 9
9 9 9 9 9 9 9 9 16 16 16 16 9 9 9 9 9 9 9 9
9 9 9 9 9 9 9 9 16 16 16 16 9 9 9 9 9 9 9 9
17 17 17 17 17 17 17 17 17 16 16 17 17 17 17 17 17 17 17 17