04 04 04 04 04 04 04 04 04 04 04 04 04 04 04 04 04 04 04 04 04 04 04 04 04 04 04 04 04 04 04 04 04 04 04 04 04 04 04 04 04 04 04 04 04 04 04 04 04 04 
04 04 04 04 04 04 04 04 04 04 04 04 04 04 04 04 04 04 04 04 04 04 04 04 04 04 04 04 04 04 04 04 04 04 04 04 04 04 04 04 04 04 04 04 04 04 04 04 04 04 
04 04 04 04 04 04 04 04 04 04 04 04 04 04 04 04 04 04 04 04 04 04 04 04 04 04 04 04 04 04 04 04 04 04 04 04 04 04 04 04 04 04 04 04 04 04 04 04 04 04 
04 04 04 04 04 04 04 04 04 04 04 04 04 04 04 04 04 04 04 04 04 04 04 04 04 04 04 04 04 04 04 04 04 04 04 04 04 04 04 04 04 04 04 04 04 04 04 04 04 04 
04 04 04 00 00 00 00 00 00 00 00 00 00 00 00 00 00 00 00 00 00 00 00 00 00 00 00 00 00 00 00 00 00 00 00 00 00 00 00 00 00 04 04 04 04 04 04 04 04 04 
04 04 04 00 00 00 04 04 04 04 04 00 00 00 00 00 00 00 00 00 00 00 00 00 00 00 00 00 00 00 00 00 00 00 00 00 00 00 00 04 04 04 04 04 04 04 04 04 04 04 
04 04 04 00 00 00 04 04 05 04 04 00 00 00 00 00 00 00 00 00 00 00 00 00 00 00 00 00 00 00 00 00 00 00 00 00 00 00 00 04 04 04 04 04 04 04 04 04 04 04 
04 04 04 00 00 00 04 04 05 04 04 00 00 00 00 00 00 00 00 00 00 00 00 00 00 00 00 00 00 00 00 00 00 00 00 00 00 00 04 04 04 04 02 02 02 02 02 04 04 04 
04 04 04 00 00 00 04 04 05 04 04 04 04 04 04 04 04 04 04 04 04 04 04 04 04 04 04 04 04 04 04 04 04 04 04 04 04 04 04 04 04 04 02 02 02 02 02 04 04 04 
04 04 04 00 00 00 04 04 05 00 00 00 00 00 00 00 00 00 00 00 00 00 00 00 00 04 04 04 04 04 04 04 04 04 04 04 04 04 00 04 04 04 02 02 02 02 02 04 04 04
04 04 04 00 00 00 04 04 05 05 05 05 05 05 05 05 05 05 05 05 05 05 05 05 05 04 04 04 04 04 04 04 04 04 04 04 04 04 04 04 04 04 02 02 02 02 02 04 04 04 
04 04 04 00 00 00 04 04 05 05 05 05 05 05 05 05 05 05 05 05 05 05 05 05 05 00 00 00 00 00 00 00 00 00 00 00 00 00 00 00 00 00 02 02 02 02 02 04 04 04 
04 04 04 00 00 00 04 04 04 04 04 05 04 04 04 04 04 04 04 04 04 04 05 05 05 00 00 00 00 00 00 00 00 00 00 00 00 00 00 00 00 00 02 02 02 02 02 04 04 04 
04 04 04 00 00 00 00 04 00 00 00 00 00 00 00 00 00 00 00 00 00 04 05 05 05 00 00 00 00 00 00 00 00 00 00 00 00 00 00 00 00 00 02 02 02 02 02 04 04 04 
04 04 04 00 00 00 00 04 00 00 00 00 00 00 00 00 00 00 00 00 00 04 05 05 05 04 04 04 04 04 04 04 04 04 04 04 00 00 00 00 00 00 02 02 02 02 02 04 04 04 
04 04 04 00 00 00 00 04 00 00 00 00 00 00 00 00 00 00 00 00 00 04 05 05 05 04 04 04 04 04 04 04 04 04 04 04 00 00 00 00 00 00 02 02 02 02 02 04 04 04 
04 04 04 04 00 00 00 04 04 04 00 00 04 04 04 04 04 04 04 04 04 04 05 05 05 04 04 04 04 04 04 04 04 04 04 04 00 00 00 00 00 00 02 02 02 02 02 04 04 04 
04 04 04 04 04 04 04 04 04 04 00 00 00 04 05 05 05 05 05 05 05 05 05 05 05 05 05 05 05 05 05 05 05 04 00 00 00 00 00 00 00 00 02 02 02 02 02 04 04 04 
04 04 04 04 04 04 04 04 04 04 00 00 00 04 05 05 05 05 05 05 05 05 05 05 05 05 05 05 05 05 05 05 05 04 00 00 00 00 00 00 00 00 02 02 02 02 02 04 04 04 
04 04 04 04 04 04 04 04 04 04 00 00 00 04 05 05 05 05 05 05 05 05 05 05 05 05 05 05 05 05 05 05 05 04 00 00 00 00 00 00 00 00 02 02 02 02 02 04 04 04 
04 04 04 04 04 04 04 04 04 04 04 04 04 04 05 05 05 05 05 05 05 05 05 05 05 05 05 05 05 05 05 05 05 04 00 00 00 00 00 00 00 00 04 04 04 04 04 04 04 04 
04 04 04 04 04 04 04 04 05 05 05 05 05 05 05 05 05 05 05 05 05 05 05 05 05 05 05 05 05 05 05 05 05 05 05 05 05 00 00 00 00 00 04 04 04 04 04 04 04 04 
04 04 04 04 04 04 04 04 05 05 05 05 05 05 05 05 05 05 05 05 05 05 05 05 05 05 05 05 05 05 05 05 05 05 05 05 05 00 00 00 00 00 04 04 04 04 04 04 04 04 
04 04 04 04 04 04 04 04 05 05 04 04 04 04 05 05 05 05 05 05 05 05 05 05 05 05 05 05 05 05 05 05 05 04 04 04 04 00 00 00 00 00 04 04 04 04 04 04 04 04 
04 04 04 04 04 04 04 04 05 05 04 00 00 04 05 05 05 05 05 05 05 05 05 05 05 05 05 05 05 05 05 05 05 04 00 00 00 00 00 00 00 00 04 04 04 04 04 04 04 04 
04 04 04 04 04 04 04 04 05 05 04 00 00 04 05 05 05 05 05 05 05 05 05 05 05 05 05 05 05 05 05 05 05 04 00 00 00 00 00 00 00 00 04 04 04 04 04 04 04 04 
04 04 04 04 04 04 04 04 05 05 04 00 00 04 05 05 05 05 05 05 05 05 05 05 05 05 05 05 05 05 05 05 05 04 00 00 00 00 00 00 00 00 04 04 04 04 04 04 04 04 
04 04 04 04 04 04 04 04 05 05 04 00 00 04 05 05 05 05 05 05 05 05 05 05 05 05 05 05 05 05 05 05 05 04 00 00 00 00 00 00 00 00 04 04 04 04 04 04 00 04 
04 04 04 04 04 04 04 04 05 05 04 00 00 04 04 04 04 04 04 04 04 04 05 05 05 04 04 04 04 04 04 04 04 04 00 00 00 00 00 00 00 00 04 04 04 04 04 04 04 04 
04 04 04 04 04 04 04 04 05 05 00 00 00 00 00 00 04 04 04 04 04 04 05 05 05 04 00 00 00 00 00 00 00 00 00 00 00 00 00 00 00 00 04 04 04 04 04 04 04 04 
04 04 04 04 04 04 04 04 05 05 00 00 00 00 00 00 04 04 04 04 04 04 05 05 05 04 00 00 00 00 00 00 00 00 00 00 00 00 00 00 00 00 04 04 04 04 04 04 04 04 
04 04 04 04 04 04 04 04 05 05 00 00 00 00 00 00 04 02 02 02 02 07 03 03 03 07 02 02 02 02 00 00 00 00 00 00 00 00 00 00 00 00 04 04 04 04 04 04 04 04 
04 04 04 04 04 04 04 04 05 05 00 00 00 00 00 00 04 02 02 02 02 07 03 03 03 07 02 02 02 02 00 00 00 00 00 00 00 00 00 00 00 00 04 04 04 04 04 04 04 04 
04 04 04 04 04 04 04 04 05 05 00 00 00 00 00 00 04 02 02 02 02 07 03 03 03 07 02 02 02 02 00 00 00 00 00 00 00 00 00 00 00 00 04 04 04 04 04 04 04 04 
04 04 04 04 04 04 04 04 05 05 05 05 05 05 05 05 04 02 02 02 02 07 03 03 03 07 02 02 02 02 00 00 00 00 00 00 00 00 00 00 00 00 04 04 04 04 04 04 04 04 
04 04 04 04 04 04 04 04 05 05 05 05 05 05 05 05 04 02 02 02 02 07 03 03 03 07 02 02 02 02 00 00 00 00 00 00 00 00 00 00 00 00 04 04 04 04 04 04 04 04 
04 04 04 04 04 04 04 04 00 00 00 00 00 00 05 05 04 04 04 04 04 04 05 05 05 04 04 04 04 04 00 00 00 00 04 04 04 04 04 04 04 04 04 04 04 04 04 04 04 04 
04 04 04 04 04 04 04 04 02 02 02 02 02 00 05 05 05 05 05 05 05 05 05 05 05 05 05 05 05 05 05 05 05 05 05 05 05 05 05 05 00 02 02 02 04 04 04 04 04 04 
04 04 04 04 04 04 04 04 02 02 02 02 02 00 05 05 05 05 05 05 05 05 05 05 05 05 05 05 05 05 05 05 05 05 05 05 05 05 05 05 00 02 02 02 04 04 04 04 04 04 
04 04 04 04 04 04 04 04 02 02 02 02 02 00 00 04 04 04 04 04 04 04 04 04 04 04 04 04 04 04 04 05 04 04 04 04 04 04 04 04 00 02 02 02 04 04 04 04 04 04 
04 04 04 04 04 04 04 04 02 02 02 02 02 00 00 04 04 04 04 00 00 00 00 00 00 00 00 00 00 00 00 00 00 00 00 00 00 00 00 00 00 02 02 02 04 04 04 04 04 04 
04 04 04 04 04 04 04 04 00 00 00 00 00 00 00 04 04 04 04 00 00 00 00 00 00 00 00 00 00 00 00 00 00 00 00 00 00 00 04 04 04 04 04 04 04 04 04 04 04 04 
04 04 04 04 04 04 04 04 04 04 04 04 04 04 04 04 04 04 04 04 04 04 04 04 04 04 04 04 04 04 04 04 04 04 04 04 04 04 04 04 04 04 04 04 04 04 04 04 04 04
04 04 04 04 04 04 04 04 04 04 04 04 04 04 04 04 04 04 04 04 04 04 04 04 04 04 04 04 04 04 04 04 04 04 04 04 04 04 04 04 04 04 04 04 04 04 04 04 04 04
04 04 04 04 04 04 04 04 04 04 04 04 04 04 04 04 04 04 04 04 04 04 04 04 04 04 04 04 04 04 04 04 04 04 04 04 04 04 04 04 04 04 04 04 04 04 04 04 04 04
04 04 04 04 04 04 04 04 04 04 04 04 04 04 04 04 04 04 04 04 04 04 04 04 04 04 04 04 04 04 04 04 04 04 04 04 04 04 04 04 04 04 04 04 04 04 04 04 04 04
04 04 04 04 04 04 04 04 04 04 04 04 04 04 04 04 04 04 04 04 04 04 04 04 04 04 04 04 04 04 04 04 04 04 04 04 04 04 04 04 04 04 04 04 04 04 04 04 04 04  